11111111
10000001
10022001
10000001
10000001
10033001
10000001
14000001
11111111