000111110
111140010
103033311
100212001
110110101
010202001
010001111
011111000
000000000