011111000
010001111
010001001
011000021
111011121
103010121
103310111
140010000
111110000